brick - кирпич
bridge - мост
brush - щётка, кисть
bucket - ведро, черпать
bulb - луковица, выпирать
button - кнопка, застёгивать
baby - ребёнок, младенец
cake - пирог
camera - камера
card - карта, чесать
cart - везти
carriage - вагон
cat - кот
chain - цепь, сеть
cheese - сыр
angle - угол, поворачивать
ant - муравей
apple - яблоко
arch - арка, дуга, выгибать
bird - птица
blade - лезвие
board - доска
boat - лодка, судно
bone - кость
book - книга
arm - рука, вооружать
army - армия
bag - сумка
ball - мяч
bank - банк
basin - бассейн
basket - корзина
bath - ванна, купаться
bed - кровать
bee - пчела
bell - колокольчик
berry - ягода
boot - ботинок, загружать
bottle - бутылка
box - коробка
boy - мальчик
brain - мозг
brake - тормоз, тормозить
branch - ветвь, отделение
chest - грудь, сундук
chin - подбородок
church - церковь
circle - круг
curtain - занавес, штора, занавешивать
cushion - подушка, смягчать
dog - собака
door - дверь
drain - утечка, истощать
drawer - ящик
dress - платье, одевать
drop - капля, опускать
ear - ухо
egg - яйцо
engine - двигатель
eye - глаз
face - лицо
farm - ферма
feather - перо, украшать
finger - палец
fish - рыба
flag - флаг, сигнализировать
floor - пол, этаж, дно
fly - муха, лететь
foot - нога
fork - вилка
air - воздух, проветривать
amount - количество, означать, составлять
amusement - развлечение
animal - животное
answer - ответ, отвечать
apparatus - аппарат
approval - одобрение
argument - спор, аргумент
art - искусство, художественный
attack - нападение, нападать
attempt - попытка, пытаться
attention - внимание
attraction - достопримечательности
authority - власть, полномочие
back - назад, спина, отступать
balance - баланс, уравновешивать
base - основной
behavior - поведение
fowl - домашняя птица
frame - структура, рамка, создавать
garden - сад
girl - девочка
glove - перчатка
goat - коза
gun - оружие
hair - волосы
hammer - молоток
hand - рука
hat - шляпа
head - голова
heart - сердце
hook - крюк, вербовать
horn - рожок
horse - лошадь
hospital - больница
house - дом
island - остров
jewel - драгоценный камень
kettle - чайник
key - ключ
knee - колено
knife - нож
knot - узел
leaf - лист, покрывать листвой
clock - часы
cloud - облако
coat - пальто, покрывать
collar - воротник, хватать
comb - расчёсывать
cord - шнур, связывать
cow - корова
cup - чашка
leg - нога
library - библиотека
line - линия, очередь, выравнивать
lip - губа
lock - замок
map - карта
match - спичка, сделки, соответствовать
monkey - обезьяна
moon - луна
mouth - рот, жевать
muscle - мускул
nail - ноготь
neck - шея, обниматься
needle - игла
nerve - нерв
net - чистый, сеть
nose - нос
nut - орех
office - офис
orange - апельсин, оранжевый
oven - духовка, печь
parcel - пакет, распределять
pen - ручка
pencil - карандаш
picture - картина
pig - свинья
pin - булавка, прикреплять
pipe - труба
plane - самолёт
plate - пластина
plow - плуг, пахать
pocket - карман, присваивать
shelf - полка
ship - корабль
shirt - рубашка
shoe - ботинок
skin - кожа, очищать
skirt - юбка
snake - змея
sock - носок
spade - лопата
sponge - губка
spoon - ложка
spring - весна
square - квадрат
stamp - печать, марка, отпечатывать
star - звезда
station - станция
stem - стебель, происходить
stick - палка, прикреплять
stocking - снабжать
stomach - живот, смелость, переваривать
store - магазин, запас
street - улица
sun - солнце
table - стол
tail - хвост, выслеживать
thread - нить, пронизывать
throat - горло
thumb - листать, большой палец
ticket - билет
toe - палец ноги
tongue - язык
tooth - зуб
town - город
train - поезд
tray - поднос
tree - дерево
trousers - брюки
umbrella - зонт
wall - стена
pot - горшок
purpose - намереваться, цель
adjust - регулировать, приспосабливать
advertisement - реклама
agreement - соглашение
belief - вера
birth - рождение
bit - частица, бит
bite - укус, кусать
blood - кровь
blow - удар, дуть
body - тело
brass - медь, руководство
bread - хлеб
breath - дыхание
brother - брат
building - здание, строение
burn - ожог, гореть
burst - взрыв, взрывать
business - бизнес, деловой
butter - масло
canvas - холст
care - забота, лечение
cause - причина, вызывать
chalk - мел, рисовать мелом
chance - шанс, случайный, рисковать
change - изменение, замена
cloth - ткань, одежда
coal - уголь
color - цвет
comfort - комфорт
committee - комитет
company - компания
comparison - сравнение
competition - соревнование
condition - условие, обуславливать
connection - связь
control - контроль
cook - готовить
copper - медь
copy - копия
cork - пробка
cotton - хлопок
cough - кашель
country - страна
cover - покрытие, покрывать, обложка
crack - первоклассный, взламывать
credit - кредит, верить
crime - преступление
crush - давка, сокрушать
cry - плакать
current - текущий, поток
curve - кривая, избегать
damage - повреждение, повреждать
danger - опасность
daughter - дочь
day - день
death - смерть
debt - долг
decision - решение
degree - уровень, градус, степень
design - намереваться
desire - желание, желать
destruction - разрушение
sour - раздражительный, сердитый, кислый
source - источник
South - юг
southern - южный
souvenir - сувенир
souvenirs - сувениры
sovereign - суверенный
soviet - советский
sow - сеять
space - пространство, место, космос
spacious - просторный, обширный
spade - лопата, заступ
spare - уделять, лишний, запасный
spared - сэкономленный
spark - искра
sparkle - сверкать, искриться
sparkler - бриллиант
sparrow - воробей
spasmodic - судорожный
spat - размолвка, звонкий удар
detail - детализировать, детали
development - развитие
digestion - вываривание
direction - управление
discovery - открытие
discussion - обсуждение
disease - болезнь
disgust - отвращение
distance - дистанция
distribution - распределение
division - подразделение
doubt - сомнение
drink - пить, напиток
driving - вождение
dust - чистить, пыль
earth - земля
edge - продвигаться, край
education - образование
effect - производить, эффект
end - заканчивать, конец
error - ошибка
event - случай, событие
example - пример
exchange - обмен, обменивать
existence - существование
expansion - расширение
experience - опыт, испытывать
expert - опытный, эксперт
fact - факт
fall - падение, осень
family - семья
father - папа
fear - бояться, страх
feeling - чувство
fiction - беллетристика, фикция
field - область, поле, выставлять
fight - борьба, бороться
fire -огонь
flame - пылать, пламя
flight - полет, рейс
flower - цветок
fold - сгиб, сворачивать
food - еда, продовольствие
force - сила, вынуждать, вызывать
form - форма
friend - друг
front - выходить, фронт, передний
fruit - фрукт
glass - стекло, стакан
gold - золото
government - государство
grain - зерно
grass - трава
grip - власть, захват, захватывать
group - группа
growth - рост
guide - гид, справочник, путеводитель
harbor - приютить, питать, вставать на якорь, гавань
harmony - гармония
hate - ненавидеть, очень не хотеть, ненависть
hearing - слушание, слух
heat - нагревать, высокая температура
help - помощь, помогать
history - история
hole - продырявливать, отверстие
hope - надежда, надеяться
hour - час
humor - юмор
ice - лёд
idea - идея
impulse - импульс
increase - увеличивать, увеличение
industry - индустрия
ink - чернила
insect - насекомое
instrument - инструмент
insurance - страховка
interest - интерес, процент, доля
invention - изобретение
iron - утюг, гладить
jelly - превращать в желе, желе
join - присоединяться, объединение, соединение
journey - путешествовать, поездка
judge - судья, судить
jump - прыгать, прыжок
kick - удар, ударить
kiss - поцелуй, целовать
knowledge - знание
land - земля
language - язык
laugh - смеяться, смех
law - законный, закон
lead - принуждать, побеждать, вести, лидерство
learning - изучение, обучение
leather - кожа
letter - письмо
level - уровень, выравнивать, направлять
lift - поднимать, лифт
light - освещать, легкий, свет
limit - ограничивать
linen - льняной, полотно
liquid - жидкий, жидкость
list - список, перечислять
loss - потеря
love - любовь
machine - машина
man - человек
mark - марка
market - рынок
mass - масса
meal - еда
measure - мера, измерять
meat - мясо
meeting - встреча
memory - память
metal - металл
middle - средний, середина
milk - молоко
mind - ум, возражать
mine - мой, месторождение, мина
minute - минута
mist - туман
money - деньги
month - месяц
morning - утро
mother - мать
motion - двигаться, движение, жест
mountain - гора, горный
move - двигать, шаг, движение
music - музыка
name - имя
nation - нация
need - потребность, требоваться
news - новости
night - ночь
noise - шум
note - примечание, отмечать
number - число, номер
observation - наблюдение
offer - предложение, предлагать
oil - масло
operation - операция, действие
opinion - мнение
order - заказ, заказывать, приказывать
organization - организация
ornament - украшение, украшать
owner - владелец
page - страница
pain - боль, причинять боль
paint - краска, рисовать, красить
paper - бумага
part - часть, отделять, разделяться
paste - приклеивать, паста
payment - оплата
peace - мир
person - персона
place - размещать, помещать, занимать место, место
push - толчок, подталкивать
quality - качество, качественный
question - вопрос
range - диапазон, располагаться
rate - норма,разряд
ray - луч
reaction - реакция
reading - чтение
reason - рассуждать, причина, разум
record - рекордный, отчёт, делать запись
regret - сожаление, сожалеть
relation - отношение
religion - религия
representative - представитель
request - запрос, просить
respect - уважение, уважать
rest - отдых, отдыхать, оставаться
reward - награда, вознаграждать
rhythm - ритм
rice - рис
river - река
road - дорога
roll - рулон, ведомость, катиться, въезжать
room - комната
rub - протирать, тереться
rule - правило
run - бег, бегать
salt - соль, солить
sand - песок
scale - измерять, масштаб
science - наука
sea - море
seat - сиденье, усаживать, место
secretary - секретарь
selection - выбор
self - сам
sense - чувство, значения, смысл, ощущать
servant - слуга
sex - секс, пол
shade - оттенок,тень, заштриховывать
shake - встряска, встряхивать, дрожать, потрясать
shame - позор, позорить
shock - шок, потрясать
side - сторона, примыкать
sign - знак, признак, подписывать
silk - шёлк
silver - серебро
sister - сестра
size - размер
sky - небо
sleep - спать
slip - промах, бланк, подсовывать, скользить
slope - наклон, клониться
smash - удар, разбиваться
smell - запах, пахнуть
smile - улыбка, улыбаться
smoke - дым, курить
sneeze - чиханье, чихать
snow - снег
soap - мыло, мылить
society - общество
son - сын
song - песня
sort - вид, сортировать
sound - звук
soup - суп
space - пространство, космос
stage - стадия, сцена, организовывать
start - начинать
statement - утверждение
steam - пар, париться, двигаться
steel - сталь
step - шаг, шагать
stitch - стежок, сшивать
stone - камень
stop - останавливаться, остановка
story - история
stretch - отрезки, протягивать, простираться
structure - структура
substance - вещество, сущность
sugar - сахар
suggestion - предложение, предположение
summer - лето
support - поддержка, поддерживать
surprise - сюрприз
swim - плаванье, плавать
system - система
talk - разговор, говорить
taste - вкус, испытывать
tax - налог, облагать налогом
teaching - обучение
tendency - тенденция
test - проверять, тест
theory - теория
thing - вещь
thought - мысль
thunder - гром, греметь
time - время
tin - олово,консервная банка
top - возглавлять, вершина, главный
touch - прикосновение, касаться
trade - торговля, обменивать
transport - транспорт, транспортировать
trick - уловка, обманывать
trouble - проблема, беспокоить
turn - поворот, поворачивать
twist - завихрение, крутить
unit - единица
use - использование, использовать
potato - картофель
prison - тюрьма
pump - насос, качать
rail - рельс, перевозить поездом
rat - крыса
receipt - квитанция
ring - кольцо, звонить
rod - прут
roof - крыша
root - корень
sail - парус
school - школа
scissors - ножницы
screw - винт
seed - семя
sheep - овцы
watch - часы
wheel - колесо, вертеть
whip - кнут, хлестать
whistle - свист, свистеть
window - окно
wing - крыло
wire - провод
worm - червь
account - счет, считать
act - действия
addition - дополнение
plant - завод, растение, прививать, сеять
play - играть
pleasure - удовольствие
point - пункт, точка, указывать
poison - яд, отравлять
polish - полировать
porter - швейцар,носильщик
position - помещать, позиция
powder - порошок
power - сила, власть
price - цена
print - печатать
process - обрабатывать, процесс
produce - продукт, производить
profit - прибыль, получать прибыль
property - свойства
prose - проза
protest - возражать, протест
pull - напряжение, тянуть
punishment - наказание
value - ценность, оценивать
verse - стих
vessel - судно, сосуд
view - вид, взгляд, рассматривать
voice - голос, высказывать
war - война
wash - мытьё, стирать, чистить
waste - ненужный, отходы, трата
water - вода
wave - волна
wax - воск, натирать воском
weather - погода
week - неделя
weight - вес, нагружать
wind - ветер
wine - вино
outdoor - на открытом воздухе
outer - внешний
outfit - снаряжение, обмундирование, оборудование
outlaw - человек вне закона, изгнанник
outlet - выход, выходное отверстие
outline - контур, конспект, план, схема, краткое содержание
output - выпуск, продукция
outrage - нарушение закона, насилие, оскорблять
portrait - портрет
ports - порты
pose - поза, ставить
position - положение
positive - положительный
positively - положительно
possess - обладать
possessed - хладнокровный, владеющий собой, одержимый
possession - владение
possibility - возможность
possible - возможный
winter - зима, зимовать
woman - женщина
wood - лес
wool - шерсть
word - слово
work - работа, работать
wound - проветривать, рана, ранить
writing - письмо
year - год
come - приходить, приезжать
get - получать, заставлять
give - давать
go - ходить, идти
keep - продолжать, держать, оставлять, не допускать
let - позволять
make - делать/сделать, заставлять
put - помещать
seem - казаться, представляться
take - брать/взять
be - быть
do - делать
have - иметь, съесть, знать
say - говорить
see - видеть
send - посылать
may - мочь
will - быть хотеть
about - о
across - через
after - после
against - против
among - среди
at - в
before - перед
between - между
by - к, в соответствии с, за, на
down - вниз
from - из
in - в
off - прочь, от
on - на
over - по
through - через
to - к, до, в
under - под
up - вверх
with - с
as - поскольку, как
for - для
of - из, о, от
till - пока, до
than - чем
a - любой, один, каждый, некий
all - все, весь
any - любой, никто
every - каждый
no - никакой, нет
other - другой
some - некоторый, немного
such - такой, таким образом
that - что
this - это, этот
i - я
he - он
you - ты, вы
who - кто
and - и
because - потому что
but - а, но
or - или
if - если
though - хотя
while - в то время как
how - как
when - когда
where - где, куда, откуда
why - почему
amusement - забава, развлечение
amusing - забавный, интересный
an - неопределенный артикль
ana - сборник изречений
analyse - анализировать, разбирать
analysis - анализ
ancestor - предок
anchor - якорь
ancient - древний
anew - снова, заново
angel - ангел
anger - гнев, злость
angle - угол, точка зрения
angrily - сердито
angry - сердитый
anguish - страдание
animal - животное
animated - оживленный, анимированный
ankle - щиколотка, лодыжка
annihilation - уничтожение
anniversary - годовщина
announce - объявлять
announced - объявлял, объявленный
again - снова
ever - когда/либо, никогда
far - самый дальний
forward - отправлять, вперед
here - здесь, сюда
near - рядом, около
now - теперь, сейчас
out - вне, снаружи
still - все еще
then - тогда
there - там, туда
together - вместе
well - хорошо, намного
almost - почти
enough - достаточно
even - еще, даже
little - маленький
much - много
not - не
only - только
quite - весьма
so - так
very - очень
tomorrow - завтра
yesterday - вчера
north - север
south - юг
east - восток
west - запад
please - пожалуйста
yes - да
able - способный, быть в состоянии
acid - кислота, кислый
angry - сердитый
beautiful - красивый
black - чёрный
boiling - кипение
bright - яркий, умный
broken - сломанный
brown - коричневый
cheap - дешёвый
chemical - химикат
chief - главный
clean - чистый, чистить
clear - ясный, очищать, оправдываться
common - общий
complex - комплекс
conscious - сознательный
cut - резать
deep - глубокий, глубоко
dependent - зависимый
early - рано, ранний
elastic - эластичный
equal - равный, равняться
fat - толстый, жир
fertile - плодородный
first - первый
fixed - неподвижный, неизменный
flat - плоский, квартира, плоскость
free - свобода, бесплатный
frequent - частый, часто посещать
full - полный
general - общий, генерал
good - хороший
great - великий, великолепный
grey - серый
hanging - вывешивание, висение
happy - счастье
hard - трудный, тяжёлый, твёрдый
healthy - здоровый
high - высокий, высоко
hollow - пустота
important - важный
jewel - драгоценный камень
kind - добрый, вид
like - подобный, любить, нравиться
living - проживание
long - долго, длинный
male - мужской, мужчина
married - женатый, замужем
material - материал
medical - медицинский
military - военный
natural - натуральный
necessary - необходимый
new - новый
normal - нормальный
open - открытый, открывать
parallel - параллельный, находить что/либо подобное
past - мимо, прошлый
physical - физический
political - политический
poor - бедный, плохой, слабый
possible - возможный
present - существующий, подарок
private - личный, приватный
probable - вероятный
quick - быстрый
quiet - тихий, успокаивать
ready - готовый, готов
read - читать
regular - регулярный
responsible - ответственный
right - верный, право
round - вокруг, круглый, раунд
same - то же самое
second - секунда, второй
separate - отдельный, отделять
serious - серьёзный
sharp - острый
smooth - гладкий, мягкий, приглаживать
sticky - липкий
stiff - жесткий
straight - прямой
strong - сильный
sudden - внезапный
sweet - сладкий
tall - высокий
thick - толстый, густой
tight - трудный
tired - усталый
true - правда, правдивый
violent - сильный, жестокий
waiting - ожидание
warm - теплый, нагревать
wet - влажный
wide - широкий
wise - мудрый
yellow - жёлтый
young - молодой
awake - активный, пробуждать, просыпаться
bad - плохой
bent - склонность, сгибать
bitter - горький, ожесточенный
blue - синий
certain - уверенный, определенный
cold - холодный
complete - полный, заканчивать
cruel - жестокий
dark - темнота, темный
dead - мёртвый
dear - дорогой
delicate - тонкий, деликатный
different - различный, другой
dirty - грязный
dry - сухой, сушить
false - фальшивый
feeble - слабый
female - женский
foolish - глупый
future - будущий, будущее
green - зелёный
ill - плохо, болеть
last - последний, длиться
late - опаздывать
left - лево, левый
loose - свободный, освобождать
loud - громкий
low - низкий
mixed - перемешанный
narrow - узкий, сужаться
old - старый
opposite - напротив, противоположный
public - публичный
rough - грубый
aeroplane - самолет
afar - далеко, вдали
affair - дело, занятие
injury - телесное повреждение
injustice - несправедливость
ink - чернила
inland - внутренний
inn - гостиница, постоялый двор
inner - внутренний
innocence - невинность, невиновность
innocent - наивный, невинный
innumerable - бесчисленный
instant - мгновение
instantly - немедленно
instead - вместо, взамен
instinct - инстинкт
instinctive - инстинктивный
institution - учреждение
instruct - инструктировать
instruction - инструкция
instructor - инструктор
instrument - инструмент
sad - расстроенный
safe - безопасный
secret - секретный
short - короткий
simple - простой
slow - медленный
small - маленький
soft - мягкий
solid - твёрдый, солидный
special - специальный
strange - странный
thin - худой, тонкий, жидкий
white - белый
wrong - неправильный, несправедливость
world - мир
discuss - обсуждать
similar - похожий
myself - себя, себе, собой
either - один из двух, тот или другой, или
accompany - сопровождать
advocate - отстаивать, защищать
aerial - воздушный, антенна
insufficient - недостаточный
insult - оскорбление
insurance - страхование, страховка
intake - поглощение
mechanic - механик
mechanical - механический
mechanics - механика
mechanism - устройство
medal - медаль
meddle - вмешиваться
medical - медицинский
medicine - медицина, лекарство
medieval - средневековый
meditate - размышлять, обдумывать
medium - средство, середина
meek - кроткий
momentum - импульс
monarch - монарх
Monday - понедельник
money - деньги
monkey - обезьяна
nine - девять
nineteen - девятнадцать
nineteenth - девятнадцатый
ninety - девяносто
ninth - девятый
nip - укус, щипать, пересечь
no - нет, никакой
noble - благородный, знатный
nobleman - дворянин
ordinarily - обыкновенным, обычным путем, обычно, нормально, в обычной степени
ordinary - обычный, простой
organ - орган
organic - органический
organization - организация
organize - организовывать
organized - организовывал
organizer - организатор
organs - органы
oriental - восточный
origin - происхождение
original - оригинал, первоначальный
originally - первоначально
originate - возникать, происходить, давать начало, порождать, создавать
ornament - украшение, орнамент, украшать
orphan - сирота, сиротский
ostrich - страус
other - другой
otherwise - иначе
ought - долженствование
our - наш
ours - наш
ourselves - себя, себе, сами
out - вне, вон, из, снаружи, наружный
outbreak - взрыв, вспышка, начало
outcome - результат
outcry - крик, протест
possibly - возможно
post - почта, после
postage - почтовые расходы
postal - почтовый
postcard - почтовая открытка
poster - плакат
postman - почтальон
postpone - отсрочивать
pot - котелок
potato - картофель
potatoes - картофель
potential - потенциал, потенциальный
potentially - потенциально
query - вопрос, спрашивать
quest - поиски
question - вопрос
questionable - сомнительный
questions - вопросы
quick - быстрый
quicker - быстрее
quickly - быстро
quiet - тихий, спокойный
quietly - тихо, спокойно
quill - катушка
quit - прекращать
quite - вполне, совсем
quiver - дрожать, трепетать, дрожь, трепет
quivering - дрожащий
quiz - опрос, проверять знания
quotation - цитата
quote - цитировать
quoted - Указанный
rabbit - кролик
rabbits - Кролики
race - раса, гонка
races - гонки
racing - гоночный
rack - полка для багажа над сиденьем
racket - ракетка
radiant - лучистый, сияющий, лучезарный
radiator - радиатор
radio - радио
radioactive - радиоактивный
raft - плот
rag - тряпка, лохмотья
rage - гнев, ярость
ragged - истрепанный, оборванный, рваный
raid - нападение
rail - рельс
railing - ограда, перила
railroad - железная дорога
railway - железная дорога
rain - дождь
rainbow - радуга
raincoat - плащ
rainy - дождливый
raise - поднимать, возвышать
raised - рельефный
raising - воспитание
rake - грабли, сгребать
ram - баран
ranch - ранчо
random - случайный, беспорядочный
rang - звонил
range - ряд, линия, диапазон
ranger - скиталец
rank - ряд, чин, выстраивать
ransom - выкуп, выкупать
rapid - быстрый
rapidly - быстро
rapt - восхищенный, похищенный
rapture - восторг, восхищение
rare - редкий, недожаренный
rarely - редко
rash - стремительный, поспешный, опрометчивый, сыпь
raspberry - малина
rat - крыса
rate - тариф, расценка, степень, оценивать
rates - стоит
rather - скорее, лучше
rational - рациональный
rattle - трещать, греметь, грохотать, треск, грохот, погремушка, трещотка
raw - сырой
ray - луч
rust - ржавчина, ржаветь
rustle - шелест, шорох, шелестеть, шуршать
rusty - заржавленный, порыжевший
rut - колея, привычка
ruth - жалость, сочувствие, участие, сострадание
rye - рожь
sabotage - саботаж, саботировать
sack - мешок
sacred - священный
sacrifice - жертва
sad - печальный
saddle - седло, седлать
sadly - печально
sadness - печаль
safe - сейф, безопасный, надежный
safeguard - гарантия
safety - безопасность
said - сказал
sail - парус, плыть
sailor - матрос
saint - святой
sake - ради, для
salad - салат, винегрет
salary - оклад
sale - распродажа
sally - поездка, прогулка
salmon - лосось
salt - соль, соленый, солить
salts - соли
salute - приветствовать, салют
salvage - спасать
salvation - спасение
same - тот же, так же, такой же
sample - образец
sanction - санкция
sand - песок
sandwich - бутерброд
sandy - песчаный
separation - отделение, разделение
September - сентябрь
sequel - продолжение, результат
sequence - последовательность
sergeant - сержант
series - серия
serious - серьезный
seriously - серьезно
sermon - проповедь
serpent - змея, змей
servant - слуга
serve - служить, обслуживать, подавать
soon - скоро, рано
sooner - охотнее
soot - сажа
soothe - успокаивать, утешать, облегчать
soothing - успокаивающий
sophisticated - сложный
sore - больной, воспаленный
sorrow - печаль
sorrowful - печальный, скорбный
sorry - сожалеющий, печальный, унылый
sort - сорт, род, вид, сортировать
sorting - сортировка
sought - искавший
soul - душа, воплощение
souls - души
sound - звук, звучать, играть
sounding - звучащий
sounds - звучит
soup - суп
speak - говорить, убеждать
speaker - оратор
speaking -- говоря, говорящий
speaks - говорит
spear - дротик, копье
special - специальный, особенный
specialist - специалист
speciality - фирменное блюдо
specialize - специализировать
specially - особенно
species - порода
specific - специфический
specifically - специфически
specification - спецификация
specified - указанный
specify - точно определять, устанавливать, предписывать, детально излагать
specimen - образец
specimens - Экземпляры, образцы
spectacle - зрелище
spectacles - очки
spectacular - производящий глубокое впечатление, впечатляющий, эффектный
speculation - размышление
speech - речь
speechless - безмолвный
speed - скорость, ускорять, спешить
speedily - быстро
speedometer - спидометр
speedy - быстрый, скорый
spell - писать или произносить по буквам
spelling - орфография, правописание
spend - тратить
spends - проводить
spent - проводил, тратил, проведенный, потраченный
sphere - сфера
spider - паук
spike - острие
spill - проливать, проливаться , рассыпать, рассыпаться
spin - прясть, крутить, крутиться
spine - позвоночный столб
spirit - дух
spirited - живой, бойкий
spirits - души
spit - плеваться, фыркать
spite - злость
spiteful - злобный
splash - брызгать, забрызгать, плескать, плеск, брызги
splendid - замечательно
splinter - щепка, осколок, заноза
split - раскалывать
spoil - портить, баловать
spoke - говорил, говоривший
sponsorship - попечительство
spoon - ложка
sport - спорт, заниматься спортом
sporting - спортивный
sports - спорт, спортивные соревнования
sportsman - спортсмен
spot - пятно
spotless - безупречный
spots - пятна
spotted - Определенный
spout - носик посуды, желоб
sprang - прыгал
spray - брызги, обрызгивать
spread - распространяться
spree - веселье, шалость
spring - весна
sprout - пускать ростки, отросток, побег
spruce - ель
spur - стимул
spurt - бить струей, делать внезапное усилие
spy - шпион, шпионить
squad - команда
turner - токарь
turnip - репа
turpentine - скипидар
turtle - черепаха
TV - телевизор, телевидение
twice - дважды, вдвое
twig - веточка, прутик
twilight - сумерки
twinkle - мерцать, сверкать, мигать, мелькать
triumphant - торжествующий, победоносный
trolley - тележка
troop - войска
troops - войска
trophy - трофей
tropical - тропический
trot - рысь, рысца, бежать рысью
trouble - неприятность, беда, беспокоить, волноваться
troubled - побеспокоил
troublesome - трудный, неприятный, капризный
trousers - брюки
trout - форель
truck - грузовик
true - правильный, верный
truly - точно, правдиво, истинно, верно
trumpet - труба
trunk - ствол, туловище
trust - доверять, доверие, вера
truth - правда, истина
truthful - правдивый
try - пробовать, пытаться
tub - кадка, лохань, ушат
tube - труба
tucked - Подвернутый
Tuesday - вторник
tumble - падать, опрокидываться
tune - мотив
tunnel - тоннель
turf - дерн
usefully - с пользой
useless - бесполезный
user - потребитель
users - Пользователи
using - пользование
usual - обыкновенный, обычный
usually - обычно, обыкновенно
utilities - предприятия коммунального обслуживания
utility - полезность, выгодность, удобства, коммунальные услуги
utilize - использовать
utmost - крайний
utter - издавать звук, произносить
uttered - Произнесенный
utterly - совершенно
vacant - свободный, незанятый
vacation - отпуск, каникулы
vaccination - прививка
vague - неопределенный, смутный
vaguely - Неопределенно
vain - напрасный, тщетный
vale - прощание
valiant - храбрый, мужественный
valid - правильный
valley - долина
valuable - ценный, дорогой
valuation - оценка
value - ценность, цена, дорожить, ценить
valuer -- оценщик
valve - клапан, створка, радио электронная лампа
van - фургон, багажный вагон
vanish - исчезать, пропадать
vanity - тщеславие
vapour - пар, пары
variability - изменчивость
variable - изменчивый, непостоянный
varied - различный
variety - разнообразие
various - различный, разный
varnish - лак, лоск, лакировать
vary - отличаться, расходиться
vase - ваза
vast - обширный, громадный
vastly - значительно
vault - свод
veal - телятина
vegetable - овощ, растение, овощной
vehemently - сильно
vehicle - транспортное средство
about - о
above - над, выше, наверху
abroad - за границей
abrupt - резкий, внезапный, крутой, обрывистый
abruptly - внезапно, резко, грубо
absence - отсутствие
absent - отсутствующий
absolute - совершенный, чистый
absolutely - абсолютно, совершенно
absorb - поглощать, всасывать, впитывать
absorbed - увлечённый чем/либо
abstract - отвлеченный, абстрактный
absurd - нелепый
absurdity - нелепость
abundance - богатство, изобилие
abundant - обильный
acacia - акация
accent - подчеркивать, произносить
accept - принимать
accepted - принятый
access - доступ, подход, доступность
accessible - доступный
accident - несчастный случай
accidental - случайный, нечаянный
accidentally - случайно, нечаянно
acclaim - провозглашать
accommodate - согласовывать, улаживать, примирять
accommodation - удобство, согласование
accompany - сопровождать
accompanying - сопровождающий
accomplice - сообщник
accomplish - выполнять
accord - согласие, гармония
accordance - согласованность, согласие, соответствие
accordingly - согласно
account - счет, оценка, причина
accuracy - точность, аккуратность
accurate - точный, правильный
accusation - обвинение
accuse - обвинять
accustom - приучать
ache - боль
achieve - достигать, успешно выполнять
achievement - выполнение, достижение
acid - кислый, кислота
acknowledge - признавать, вознаграждать
acorn - желудь
acquaintance - знакомство, знакомый
acquire - приобретать
acquired - приобретённый
acquisition - приобретение
acquit - оправдывать
across - через
act - акт, дело, действовать
acting - временно исполняющий обязанности, игра
action - действие, поступок
active - активный
actively - активно, деятельно
activity - деятельность, активность
actor - актер
actress - актриса
actual - текущий, современный
actually - фактически, в настоящее время
acute - острый, проницательный
adapt - приспособить, переделать
add - добавлять, прибавлять
addition - прибавление, сложение
additional - дополнительный
address - адрес, обращение
adept - знаток, сторонник
adequate - достаточный, соответствующий
adhere - прилипать, приставать, приклеиваться, хвататься
adjust - регулировать, приспосабливать
adjustment - регулирование
administration - администрация
administrator - администратор
admirable - замечательный
admiral - адмирал
admiration - восхищение
admire - восхищаться
admired - восхищался
admission - допуск, вход, прием
admit - допускать
admittance - впуск, доступ
adopt - принимать, присваивать
adore - обожать
adorn - украшать
adrift - по течению, по воле волн
ads - реклама
adult - взрослый
adults - взрослые
advance - продвижение вперед, продвигать
advanced - передовой
advantage - преимущество, выгода
adventure - рисковать, отваживаться
adventurer - искатель приключений, авантюрист
adventurous - отважный, предприимчивый
adversary - противник
adversity - бедствие, несчастье
advertise - помещать объявление, рекламировать
advertisement - объявление, реклама
advice - совет
advise - советовать
advocate - отстаивать, защищать
aerial - воздушный, антенна
aeroplane - самолет
afar - далеко, вдали
affair - дело, занятие
affairs - делишки
affect - влиять, трогать, вредить
affected - пораженный
affection - привязанность, любовь
affectionate - любящий, нежный
affirmative - утвердительный
afford - позволить себе
affray - пугать
afore - перед
afraid - испуганный
afresh - снова, опять
after - после
afternoon - время после полудня
afterwards - впоследствии, позже
again - снова
against - против
age - век, возраст
aged - старый, в возрасте
agency - агентство
agent - деятель, исполнитель
aggregate - совокупность
agitation - агитация
agony - мучение, сильная боль
agree - соглашаться
agreeable - приятный, милый
agreed - согласился
agreement - согласие, соглашение
agricultural - сельскохозяйственный
agriculture - сельское хозяйство
ahead - вперед
aid - помощь
ailing - больной
aim - целиться, цель
air - воздушный, авиационный, проветривать
airborne - авиационный
airliner - лайнер
airport - аэропорт
ajar - приоткрытый
alarm - тревога, тревожить
album - альбом
alert - бдительный, проворный
alight - выходить, спускаться
alignment - выравнивание, линия
alike - похожий
alive - живой
all - все, весь
allegiance - преданность, верность
alley - аллея, переулок
allied - союзный, родственный
allocate - предназначать
allocation - распределение, назначение
bathe - купаться
bathing - купание, купальный
bathroom - ванная комната
battery - аккумулятор
battle - бой, сражение
bay - бухта, залив
be - быть
beach - пляж
beacon - сигнальный огонь, маяк
beagle - гончая
beak - клюв
beaker - кубок, чаша
beam - сиять, излучать свет
bean - боб
beans - фасоль
bear - медведь, спекулянт
bearable - терпимый, сносный
beard - борода
bearer - носитель, податель, предъявитель
bears - медведи
beast - зверь, животное
beastly - противный
beasts - звери
beat - ударить, бить
beaten - битый
beating - поражение
beau - кавалер, поклонник
charm - очарование
charming - очаровательный, прелестный
charms - обаяния
chase - охотиться, преследовать, погоня, охота
chasing - уклоняющийся
chat - беседа, болтовня
chatter - болтать, болтовня
chatterbox - болтунья
chauffeur - шофер
cheap - дешевый
cheaply - дешево, легко
cheat - обманывать, надувать, обманщик, плут
check - проверять, регистрировать
cheek - щека
cheeky - развязный
cheer - настроение
cheerful - жизнерадостный, веселый
cheerfully - бодро
cheers - да здравствует
cheese - сыр
chemical - химический
chemist - химик, аптекарь
chemistry - химия
cheque - банковский чек
cherish - лелеять
cherries - вишни
cherry - вишня
chess - шахматы
chest - грудь
chestnut - каштан
chevy - охота, погоня, гнаться
chew - жевать
chicken - цыпленок, кура
chief - шеф, начальник
chiefly - главным образом
child - ребенок
childhood - детство
childish - детский, ребяческий
children - дети
chill - холод, простуда
chilly - холодный, сухой, чопорный
chimney - труба
chin - подбородок
china - фарфор
chip - обломок, осколок
chisel - резец, ваять, высекать
chivalrous - рыцарский
chocolate - шоколад
choice - выбор
choose - выбирать
chorus - хор
Christian - христианский, христианин
Christmas - Рождество
chronicle - летопись, хроника, отмечать
chuckled - Хихикал
church - церковь
churchyard - кладбище
cigar - сигара
cigarette - сигарета
cigarettes - сигареты
cinema - кино
circle - амфитеатр, круг
circuit - кругооборот, окружность
circular - круглый, реклама
circulate - повторяться, передаваться
circulation - кровообращение, тираж
circumference - окружность
circumstance - обстоятельство, условие
circumstances - обстоятельства, условия
circumstantial - обстоятельный, случайный
circus - цирк, арена
citizen - гражданин
city - город
civil - гражданский
civilization - цивилизация
claim - требовать
clamour - шум, крики
clamp - складывать, скреплять
clank - бряцать, хлопать в ладоши
clap - хлопать, аплодировать, удар, хлопок
clash - столкновение, конфликт
clasp - прижимать, обнимать, сжимать
class - класс
classes - занятия, уроки
classic - классический
classroom - класс
clatter - стук, звон, стучать, греметь
clause - предложение, статья
claw - коготь, клешня
clay - глина, земля
clean - чистить, чистый
cleaned - чистил, чищенный
cleaning - чистка
cleanliness - чистоплотность
clear - ясный, светлый, очищать, расплатиться
cleared - рассчитался
clearly - ясно
clench - сжимать кулаки
clergyman - священник
clerk - чиновник
clever - умный
click - щелкать
client - клиент
cliff - утес, скала
climate - климат
climax - кульминационный пункт
climb - подниматься, влезать
cling - цепляться, прильнуть
clink - звенеть, звон
clip - стричь, обрезать, зажимать
cloak - плащ, камера хранения
clock - часы
close - закрывать
closed - закрыл, закрытый
closely - близко, тесно
closet - чулан
closing - заключительный
closure - закрытие
cloth - ткань
clothe - одевать
clothes - одежда
clothing - одежда, обмундирование
cloud - облако
club - клуб
clue - ключ к разгадке, улика
clumsy - неуклюжий
cluster - гроздь, скопляться, тесниться
clutch - захват
coach - тренировать, инструктор
coal - уголь
coarse - грубый
coast - побережье
coat - пальто
coax - уговаривать, задабривать
cobbler - сапожник
cobweb - паутина
cock - петух, задирать
cocktail - коктейль
cocoa - какао
cocoon - кокон
code - код
coffee - кофе
cognomen - прозвище, фамилия
coil - виток, катушка
coin - монета
coincidence - совпадение
coins - монеты
cold - холод, холодный
collapse - крушение, крах, рушиться, потерпеть крах
collar - воротник
colleague - коллега
collect - коллекционировать
collected - коллекционировал
collection - коллекция
collections - собирание, выемка
collector - сборщик, коллекционер
college - колледж
collision - столкновение
colon - двоеточие
colonel - полковник
colonial - колониальный
colonize - заселять, колонизировать
colony - колония
colorful - красочный
colour - цвет
coloured - цветной
colourful - красочный
colours - цвета
column - графа, отдел
columns - Колонки
comb - гребенка, расчесывать, расчесать
combat - бой, борьба
combination - комбинация, объединение
combine - объединять
combined - Объединенный
come - приходить, приезжать
comedy - комедия
comely - хорошенький, миловидный
comer - приходящий
comfort - удобство, утешение, утешать
comfortable - удобный
comic - кинокомедия, комический
comics - комиксы
coming - приход, приходящий
comma - запятая
command - приказ, управлять, приказывать
commander - командир, начальник
commands - Команды
commend - хвалить
comment - комментарий, комментировать
commerce - торговля, коммерция
commercial - торговый
commission - комиссионные
commit - совершать
beautiful - красивый
beautifully - красиво, прекрасно
beauty - красота, косметический
became - становился, стал
because - потому что
beck - кивок, приветствие
become - становиться
becoming - подобающий, приличествующий, соответственный, идущий
bed - постель
bedding - спальные принадлежности
bedroom - спальня
bedside - постель
bee - пчела
beech - бук
beef - говядина
beehive - улей
beer - пиво
beetle - трамбовать, дробить камни
beetroot - красная свекла
before - перед, до того как
beforehand - заранее
beg - просить, умолять
began - начинал, начал
beggar - нищий
begin - начинать, начинаться
beginner - новичок
beginning - начало
begins - начинается
behave - вести себя
behaviour - поведение
behind - позади
being - будучи
belfry - колокольня
belief - вера, доверие
believe - верить
believed - верил, полагал
bell - звонок
bellow - мычание, греметь, громыхать
belly - живот, аппетит
belong - принадлежать
belonged - принадлежащий
belongings - вещи, пожитки
beloved - любимый
below - ниже, внизу
belt - пояс, ремень
bench - скамейка
bend - гнуться, изгибаться
beneath - под, ниже, внизу
benefit - благо, польза
bent - склонность, наклонность
berries - ягоды
berth - койка, спальное место
beset - окружать
beside - рядом, около
besides - кроме, кроме того
best - наилучший
bet - держать пари, пари
betray - предавать
better - лучше
between - между
bewail - оплакивать, скорбеть
beware - осторожно
bewildered - пораженный, изумленный
beyond - далеко, вдали, на расстоянии, вне, сверх
Bible - библия
bicycle - велосипед
bicyclelist - велосипедист
bidding - понижение цены
big - большой
bike - велосипед
bill - счет, законопроект
billion - биллион, миллиард
bin - бункер
binary - набор из двух предметов
bind - связывать
binding - переплет
bingo - лото
biology - биология
birch - береза, розга
bird - птица
birth - рождение
birthday - день рождения
biscuit - сухое печенье
bishop - епископ, слон
bit - кусочек, немного
bite - кусаться
biting - острый, резкий
bits - куски
bitter - горький, мучительный
bitterly - горько, сильно
blab - болтун, болтать
black - черный
blackbird - черный дрозд
blacken - чернить, чернеть
blade - лезвие
blame - считать виноватым, вина, упрек, порицание
blank - пустой, чистый
blanket - одеяло
blast - взрыв, взрывать, разрушать
blaze - пламя, пылать, гореть
blazing - Сверкание
bleach - белить
bleeding - кровотечение
blend - смешивать, смесь
bless - благословлять
blessed - благословлённый
blessing - благословение
blew - дул
blind - слепой
blink - мерцание, отблеск, блеснуть, моргать
bliss - блаженство, счастье
blizzard - метель, пурга
blob - капля, комочек
block - блок, квартал
blockade - блокада
blocks - кварталы
blond - белокурый
blonde - блондин
blood - кровь
bloody - кровавый
bloom - цветение
blossom - цветок на деревьях, расцветать
blot - клякса, пятно, промокать
blouse - блуза
blow - дуть
blue - синий
blunt - притуплять
blush - краснеть, краска стыда, смущения
board - садиться на пароход, самолет, доска
boarding - посадка смолета
allow - разрешать, разрешить
allowance - дозволение, допущение
alloy - примесь, сплав
ally - союзник, соединять
almond - миндаль, миндалина
almost - почти, едва не
aloft - наверху, наверх
alone - один, одинокий
along - вдоль
alongside - рядом
aloud - громко, вслух
alphabet - алфавит, азбука
already - уже
also - тоже, также
alter - изменять
alteration - изменение, перемена
alternate - переменный
alternative - альтернатива, выбор
although - хотя
altitude - высота
altogether - всего, в общем
always - всегда
amateur - любитель
amazed - изумлённый, поражённый
amazement - удивление, изумление
amber - янтарь, янтарный
ambiguous - двусмысленный
ambition - честолюбие, желание
ambitious - честолюбивый
ambulance - полевой госпиталь, карета скорой помощи
amends - возмещение
amiable - любезный, милый
amid - между, посреди, среди
ammonia - аммиак
ammunition - боеприпасы
among - среди
amongst - Среди
amorous - влюбленный, любовный
amount - количество, сумма, составлять
ample - обширный, просторный
amuse - забавлять, развлекать
define - определять, устанавливать
defined - определенный
definite - определенный, точный
definition - определение
defy - действовать наперекор
degrade - понижать, разжаловать
degree - степень, звание
deity - божество
dejected - удрученный, угнетенный
delay - отсрочка
delayed - отложен
delete - Удалить
deliberate - умышленный, обдуманный
deliberately - сознательно, обдуманно
delicacy - деликатность, тонкость, нежность красок, хрупкость, болезненность
delicate - изящный
delicious - восхитительный, прелестный, вкусный
delight - восхищение, восхищаться
delighted - восхищался
delightful - восхитительный
delirium - бред
deliver - доставлять, передавать
deliverance - освобождение, избавление
delivered - доставил
delivery - доставка
deluge - наводнение, ливень
delusion - заблуждение
delve - впадина, рытвина
demand - требовать
demanded - требовал
demolition - уничтожение
demonstrate - демонстрировать
demonstration - демонстрация
den - берлога, притон
dene - долина, дюны
denial - отрицание, опровержение
denote - означать, обозначать
dense - густой, плотный
dentist - зубной врач
deny - отрицать, отвергать
depart - отбывать, уезжать
department - отдел
departments - отделы, отделения
departure - отъезд, отправление
depend - зависеть
dependant - иждивенец
dependent - зависимый, зависящий
deplore - сожалеть
deploy - развертывать
deployment - развертывание
deposit - взнос, вклад, залог, сдавать на хранение
depression - уныние, депрессия экономическая
deprive - лишать, отбирать
depth - глубина
deputy - депутат, делегат
derisive - насмешливый, иронический
derived - Полученный
descend - спускаться
descendant - потомок
descent - спуск, склон, десант, происхождение
describe - описывать
description - описание
desert - пустыня
deserted - брошенный, пустынный
deserter - дезертир
deserts - заслуги
deserve - заслуживать
deserved - заслуженный
deserves - Заслуживает
design - проектировать, спроектировать
designed - предназначенный, намеренный
designer - конструктор
designs - Проекты
desirable - желательный
desire - желание
desk - письменный стол
desolate - покинутый, заброшенный
desperate - отчаянный, безнадежный
desperately - отчаянно
despise - презирать
despite - несмотря на
dessert - десерт
destination - место назначения
destitute - нуждающийся
destroy - разрушать, уничтожать
destroyer - эскадренный миноносец
destruction - разрушение
detach - отделять, посылать
detached - отдельный
detachment - отряд
detail - деталь
detailed - детальный, подробный
detain - задерживать, удерживать
detect - открывать, обнаруживать
detected - Обнаруженный
detection - открытие, обнаружение
detective - детектив
detention - задержание
determination - решимость, определение
determine - определять, устанавливать, разрешать
determined - решительный
detest - питать отвращение, ненавидеть
detrimental - приносящий ущерб
develop - развивать
developed - развил
developer - развивающийся
development - развитие
device - прибор, схема, проект, прием, устройство
devil - дьявол, сатана
devote - посвящать
devoted - преданный
devotion - преданность
devour - пожирать
dew - роса
dexterity - проворство, ловкость
diagram - диаграмма, схема
dial - набирать номер
dialogue - диалог
diameter - диаметр
diamond - алмаз, бриллиант
diary - дневник
dictionary - словарь
dictum - изречение, поговорка
did - делал, действовал
die - штамповать, чеканить
died - умер, умерший
diet - диета
differ - различать
difference - разница, различие
differences - Различия
different - другой, отличный от
differs - Отличается
difficult - трудный
difficulty - препятствие, затруднение
dig - копать
digest - переваривать, усваивать, краткое изложение
digestion - пищеварение
digging - Рытье
dignified - достойный
dignity - достоинство
diligence - прилежание
dim - тусклый, неясный, слабый, туманный, смутный
dime - дайм
dimly - смутно
din - шум, долбить
dine - обедать
dining - обеденный
discourage - обескураживать